20
20
0 0 0 0 0 0 0 0 0 0 0 0 0 0 0 0 0 0 0 0 
0 0 0 0 0 0 0 0 0 0 0 0 0 0 0 0 0 0 0 0 
0 0 0 0 0 0 0 0 0 0 0 0 0 0 0 0 0 0 0 0 
0 0 0 0 0 0 0 0 0 0 0 0 0 0 0 0 0 0 0 0 
0 0 0 0 0 0 0 0 0 0 0 0 0 0 0 0 0 0 0 0 
0 0 0 0 0 0 0 0 0 0 0 0 0 0 0 0 0 0 0 0 
0 0 0 0 0 0 0 0 0 0 0 0 0 0 0 0 0 0 0 0 
0 0 0 0 0 0 0 0 0 0 0 0 0 0 0 0 0 0 0 0 
0 0 0 0 0 0 0 0 0 0 0 0 0 0 0 0 0 0 0 0 
0 0 0 0 0 0 0 0 0 0 0 0 0 0 0 0 0 0 0 0 
0 0 0 0 0 0 0 5 0 9 0 5 0 4 0 0 0 0 0 0 
0 0 0 0 0 0 0 0 4 4 4 0 0 4 0 0 0 0 0 0 
0 0 5 0 0 9 0 0 0 5 0 4 0 4 0 0 0 0 0 0 
0 0 0 4 4 4 4 4 4 0 0 0 0 4 0 0 0 0 0 0 
0 0 0 0 0 0 0 0 0 4 0 0 4 4 0 0 0 0 0 0 
1 0 0 0 0 0 0 0 0 0 0 0 0 4 0 0 0 0 0 0 
3 3 3 3 3 3 3 3 3 7 7 7 7 7 7 7 7 3 3 3 
2 2 2 2 2 2 2 2 2 7 7 7 7 7 7 7 7 2 2 2 
2 2 2 2 2 2 2 2 2 7 7 7 7 7 7 7 7 2 2 2 
2 2 2 2 2 2 2 2 2 2 2 2 2 2 2 2 2 2 2 2 